{
    "groundTextureUrl": "./../../assets/textures/ground.jpg",
    "wallTextureUrl": "../../../assets/textures/wall.jpg",
    "elevatorTextureUrl": "../../../assets/textures/elevator.jpg",
    "emergencyExitTextureUrl": "../../../assets/textures/emergencyExit.jpg",
    "exitTextureUrl": "../../../assets/textures/exit.jpg",
    "doorTextureUrl": "../../../assets/textures/door_front.png",
    "size": { "width": 12, "height": 20 },
    "map": [
        [3, 2, 3, 2, 2, 2, 2, 2, 2, 2, 2, 2, 1],
        [5, 0, 11, 0, 0, 0, 0, 0, 0, 0, 0, 0, 1],
        [3, 2, 1, 0, 0, 0, 0, 3, 2, 2, 10, 2, 1],
        [1, 0, 1, 0, 0, 0, 0, 1, 0, 0, 0, 0, 1],
        [1, 0, 11, 0, 0, 0, 0, 1, 0, 0, 0, 0, 1],
        [1, 0, 1, 0, 0, 0, 0, 1, 0, 0, 0, 0, 1],
        [3, 2, 2, 2, 1, 0, 0, 3, 2, 2, 2, 2, 1],
        [1, 0, 0, 0, 1, 0, 0, 11, 0, 0, 0, 0, 1],
        [1, 0, 0, 0, 1, 0, 0, 1, 0, 0, 0, 0, 1],
        [1, 0, 0, 0, 1, 0, 0, 1, 0, 0, 0, 0, 1],
        [1, 0, 0, 0, 11, 0, 0, 1, 0, 0, 0, 0, 1],
        [1, 0, 0, 0, 1, 0, 0, 3, 2, 2, 2, 2, 1],
        [3, 2, 2, 2, 1, 0, 0, 11, 0, 0, 0, 0, 1],
        [1, 0, 0, 0, 1, 0, 0, 1, 0, 0, 0, 0, 1],
        [1, 0, 0, 0, 11, 0, 0, 3, 2, 2, 2, 2, 1],
        [1, 0, 0, 0, 1, 0, 0, 1, 0, 0, 0, 0, 1],
        [1, 0, 0, 0, 1, 0, 0, 1, 0, 0, 0, 0, 1],
        [1, 0, 0, 0, 1, 0, 0, 1, 0, 0, 0, 0, 1],
        [1, 0, 0, 0, 1, 0, 0, 11, 0, 0, 0, 0, 1],
        [1, 0, 0, 0, 1, 0, 0, 1, 0, 0, 0, 0, 1],
        [2, 2, 2, 2, 2, 2, 2, 2, 2, 2, 2, 2, 0]
      ],
    "initialPosition": [0, 0],
    "initialDirection": 0.0,
    "exitLocation": [-1, 21],
    "elevatorLocations": [1, 0]
}

