{
    "maze": {
        "size": { "width": 12, "depth": 20 },
        "map":[
            [3, 2, 3, 2, 2, 2, 2, 2, 2, 2, 2, 2, 7],
            [5, 0, 11, 0, 0, 0, 0, 0, 0, 0, 0, 0, 7],
            [3, 2, 2, 2, 1, 0, 0, 3, 2, 2, 2, 2, 1],
            [1, 0, 0, 0, 11, 0, 0, 1, 0, 0, 0, 0, 1],
            [1, 0, 0, 0, 1, 0, 0, 1, 0, 0, 0, 0, 1],
            [1, 0, 0, 0, 1, 0, 0, 1, 0, 0, 0, 0, 1],
            [3, 2, 2, 2, 1, 0, 0, 1, 0, 0, 0, 0, 1],
            [1, 0, 0, 0, 1, 0, 0, 1, 0, 0, 0, 0, 1],
            [1, 0, 0, 0, 1, 0, 0, 1, 0, 0, 0, 0, 1],
            [1, 0, 0, 0, 11, 0, 0, 11, 0, 0, 0, 0, 1],
            [1, 0, 0, 0, 1, 0, 0, 1, 0, 0, 0, 0, 1],
            [1, 0, 0, 0, 1, 0, 0, 1, 0, 0, 0, 0, 1],
            [3, 2, 2, 2, 1, 0, 0, 2, 3, 2, 2, 2, 1],
            [1, 0, 0, 0, 1, 0, 0, 0, 1, 0, 0, 0, 1],
            [1, 0, 0, 0, 11, 0, 0, 0, 11, 0, 0, 0, 1],
            [1, 0, 0, 0, 1, 0, 0, 0, 1, 0, 0, 0, 1],
            [1, 0, 0, 0, 1, 0, 0, 0, 1, 0, 0, 0, 1],
            [1, 0, 0, 0, 3, 2, 10, 2, 2, 2, 2, 2, 1],
            [1, 0, 0, 0, 1, 0, 0, 0, 0, 0, 0, 0, 1],
            [1, 0, 0, 0, 1, 0, 0, 0, 0, 0, 0, 0, 1],
            [2, 2, 2, 2, 2, 2, 2, 2, 2, 2, 2, 2, 0]
          ],
        "exits": [[0,11],[1,11]],
        "elevators": [
            [1,0]
        ],
        "exitLocation": [-3,-3]
    }
}