{
    "maze": {
        "size": { "width": 12, "depth": 20 },
        "map": [
            [3, 2, 2, 2, 3, 2, 2, 2, 2, 2, 2, 2, 1],
            [1, 0, 0, 0, 1, 0, 0, 0, 0, 0, 0, 0, 1],
            [1, 0, 0, 0, 1, 0, 0, 0, 0, 0, 0, 0, 1],
            [1, 0, 0, 0, 1, 0, 0, 0, 0, 0, 0, 0, 1],
            [1, 0, 0, 0, 3, 10, 2, 3, 2, 2, 2, 2, 1],
            [1, 0, 0, 0, 1, 0, 0, 1, 0, 0, 0, 0, 1],
            [1, 0, 0, 0, 11, 0, 0, 11, 0, 0, 0, 0, 1],
            [1, 0, 0, 0, 1, 0, 0, 1, 0, 0, 0, 0, 1],
            [3, 2, 2, 2, 0, 0, 0, 2, 2, 2, 2, 2, 1],
            [7, 0, 0, 0, 0, 0, 0, 0, 0, 0, 0, 0, 1],
            [1, 0, 0, 0, 0, 0, 3, 2, 2, 2, 2, 10, 1],
            [1, 0, 0, 0, 0, 0, 1, 0, 0, 0, 0, 0, 1],
            [3, 2, 11, 0, 0, 0, 3, 2, 2, 2, 2, 2, 1],
            [5, 0, 1, 0, 0, 0, 1, 0, 0, 0, 0, 0, 1],
            [3, 2, 0, 0, 0, 0, 2, 2, 2, 2, 2, 10, 1],
            [7, 0, 0, 0, 0, 0, 0, 0, 0, 0, 0, 0, 1],
            [3, 2, 10, 2, 3, 10, 2, 2, 3, 10, 2, 2, 1],
            [1, 0, 0, 0, 1, 0, 0, 0, 1, 0, 0, 0, 1],
            [1, 0, 0, 0, 1, 0, 0, 0, 1, 0, 0, 0, 1],
            [1, 0, 0, 0, 1, 0, 0, 0, 1, 0, 0, 0, 1],
            [2, 2, 2, 2, 2, 2, 2, 2, 2, 2, 2, 2, 0]
          ],
        "exits": [],
        "elevators": [
            [13,0]
        ],
        "exitLocation": [-3,-3]
    }
}