{
    "maze": {
        "size": { "width": 12, "depth": 20 },
        "map": [
            [3, 2, 2, 2, 2, 3, 2, 2, 2, 2, 2, 2, 1],
            [1, 0, 0, 0, 0, 1, 0, 0, 0, 0, 0, 0, 1],
            [1, 0, 0, 0, 0, 1, 0, 0, 0, 0, 0, 0, 1],
            [1, 0, 0, 0, 0, 1, 0, 0, 0, 0, 0, 0, 1],
            [1, 0, 0, 0, 0, 3, 10, 2, 2, 2, 2, 2, 1],
            [1, 0, 0, 0, 0, 1, 0, 0, 0, 0, 0, 0, 1],
            [1, 0, 0, 0, 0, 11, 0, 3, 1, 0, 0, 0, 1],
            [1, 0, 0, 0, 0, 1, 0, 11, 2, 2, 2, 2, 1],
            [3, 2, 2, 2, 2, 0, 0, 1, 0, 0, 0, 0, 1],
            [7, 0, 0, 0, 0, 0, 0, 1, 0, 0, 0, 0, 1],
            [7, 0, 0, 0, 0, 0, 0, 1, 0,0, 0, 0, 1],
            [3, 1, 0, 0, 0, 0, 0, 2, 2, 2, 2, 2, 1],
            [5, 2, 11, 0, 0, 0, 0, 0, 0, 0, 0, 0, 1],
            [3, 2, 2, 2, 2, 2, 10, 2, 2, 2, 2, 2, 1],
            [1, 0, 0, 0, 0, 0, 0, 0, 0, 0,0, 0, 1],
            [1, 0, 0, 0, 0, 0, 0, 0, 0, 0, 0, 0, 1],
            [1,0, 0, 0, 0, 0, 0, 0, 0, 0, 0, 0, 1],
            [1, 0, 0, 0, 0, 0, 0, 0, 0, 0, 0, 0, 1],
            [1, 0, 0, 0, 0, 0, 0, 0, 0, 0, 0, 0, 1],
            [1, 0, 0, 0, 0, 0, 0, 0, 0, 0, 0, 0, 1],
            [2, 2, 2, 2, 2, 2, 2, 2, 2, 2, 2, 2, 0]
          ],
        "exits": [[10,0],[9,0]],
        "elevators": [
            [12,0]
        ],
        "exitLocation": [-3,-3]
    }
}