{
  "groundTextureUrl": "./../../assets/textures/ground.jpg",
  "wallTextureUrl": "../../../assets/textures/wall.jpg",
  "elevatorTextureUrl": "../../../assets/textures/elevator.jpg",
  "emergencyExitTextureUrl": "../../../assets/textures/emergencyExit.jpg",
  "exitTextureUrl": "../../../assets/textures/exit.jpg",
  "doorTextureUrl": "../../../assets/textures/door_front.png",
  "size": { "width": 24, "height": 12 },
  "map": [
    [3, 2, 2, 2, 2, 3, 2, 2, 2, 2, 2, 2, 2, 3, 2, 2, 2, 2, 2, 3, 2, 2, 2, 2, 1],
    [1, 0, 0, 0, 0, 1, 0, 0, 0, 0, 0, 0, 0, 1, 0, 0, 0, 0, 0, 1, 0, 0, 0, 0, 1],
    [1, 0, 0, 0, 0, 1, 0, 0, 0, 0, 0, 0, 0, 1, 0, 0, 0, 0, 0, 1, 0, 0, 0, 0, 1],
    [1, 0, 0, 0, 0, 1, 0, 0, 0, 0, 0, 0, 0, 1, 0, 0, 0, 0, 0, 1, 0, 0, 0, 0, 1],
    [3, 2, 10, 2, 2, 2, 10, 2, 2, 2, 2, 2, 2, 2, 10, 2, 2, 2, 2, 2, 10, 2, 2, 2, 1],
    [1, 0, 0, 0, 0, 0, 0, 0, 0, 0, 0, 0, 0, 0, 0, 0, 0, 0, 0, 0, 0, 0, 0, 0, 1],
    [1, 0, 0, 0, 0, 0, 0, 0, 0, 0, 0, 0, 0, 0, 0, 0, 0, 0, 0, 0, 0, 0, 0, 0, 1],
    [1, 0, 0, 0, 0, 0, 0, 0, 0, 0, 0, 0, 0, 0, 0, 0, 0, 0, 0, 0, 0, 0, 0, 0, 1],
    [3, 2, 10, 2, 2, 1, 0, 3, 2, 2, 2, 2, 3, 2, 2, 2, 2, 2, 10, 1, 0, 0, 3, 0, 1],
    [1, 0, 0, 0, 0, 1, 0, 1, 0, 0, 0, 0, 1, 0, 0, 0, 0, 0, 0, 1, 0, 0, 1, 0, 5],
    [1, 0, 0, 0, 0, 1, 0, 11, 0, 0, 0, 0, 1, 0, 0, 0, 0, 0, 0, 3, 10, 2, 2, 2, 1],
    [1, 0, 0, 0, 0, 1, 0, 1, 0, 0, 0, 0, 1, 0, 0, 0, 0, 0, 0, 1, 0, 0, 0, 0, 1],
    [2, 2, 2, 2, 2, 2, 2, 2, 2, 2, 2, 2, 2, 2, 2, 2, 2, 2, 2, 2, 2, 2, 2, 2, 0]
  ],
  "initialPosition": [9, 18],
  "initialDirection": 0.0,
  "exitLocation": [],
  "elevatorLocations": [9, 23]
}

