{
    "maze": {
        "size": { "width": 22, "depth": 10 },
        "map": [
            [3, 2, 2, 2, 2, 3, 2, 2, 2, 3, 2, 2, 2, 3, 2, 2, 2, 3, 2, 2, 3, 4, 1],
            [1, 0, 0, 0, 0, 1, 0, 0, 0, 1, 0, 0, 0, 1, 0, 0, 0, 1, 0, 0, 1, 0, 1],
            [1, 0, 0, 0, 0, 1, 0, 0, 0, 1, 0, 0, 0, 1, 0, 0, 0, 3, 10, 2, 10, 2, 1],
            [1, 0, 0, 0, 0, 1, 0, 0, 0, 1, 0, 0, 0, 1, 0, 0, 0, 1, 0, 0, 0, 0, 1],
            [1, 0, 0, 0, 0, 3, 2, 2, 10, 2, 10, 2, 2, 10, 2, 2, 2, 0, 0, 0, 0, 0, 1],
            [1, 0, 0, 0, 0, 11, 0, 0, 0, 0, 0, 0, 0, 0, 0, 0, 0, 0, 0, 0, 0, 0, 7],
            [1, 0, 0, 0, 0, 1, 0, 0, 0, 0, 0, 0, 0, 0, 0, 0, 0, 0, 0, 0, 0, 0, 7],
            [3, 2, 2, 2, 2, 2, 2, 2, 10, 2, 3, 10, 2, 2, 1, 2, 2, 2, 1, 0, 0, 0, 1],
            [1, 0, 0, 0, 0, 0, 0, 0, 0, 0, 1, 0, 0, 0, 1, 0, 0, 0, 3, 10, 2, 2, 1],
            [1, 0, 0, 0, 0, 0, 0, 0, 0, 0, 1, 0, 0, 0, 1, 0, 0, 0, 1, 0, 0, 0, 1],
            [2, 2, 2, 2, 2, 2, 2, 2, 2, 2, 2, 2, 2, 2, 2, 2, 2, 2, 2, 2, 2, 2, 0]
          ],
        "exits": [
            [4.0, 22.0],
            [5.0, 22.0]
        ],
        "elevators": [
            [0, 21]
        ],
        "exitLocation": [4.0, 22.0]
    }
}